+-+-+-+-+-+-+-+-+-+
|p    |           |
+-+-+ + +-+-+-+ +-+
|   |     |   |   |
+ + +-+-+-+ + +-+ +
| | |       | |   |
+ + + +-+-+-+ + + +
| | |       |   | |
+ + + +-+-+ +-+-+ +
| | |     | |     |
+ + +-+-+ + +-+-+ +
| |   | | |     | |
+ +-+ + + +-+-+ +-+
| | | | | |   |   |
+ + + + + + +-+-+ +
| |   |     |   | |
+-+ +-+-+-+-+ + + +
|             |  g|
+-+-+-+-+-+-+-+-+-+