+-+-+-+-+-+-+
|p          |
+ +-+ +-+-+-+
|   |   |   |
+-+-+-+ + + +
|     |   | |
+ +-+ +-+ + +
|   |   | | |
+-+ +-+ +-+ +
|   | |   | |
+ +-+ +-+-+ +
|          g|
+-+-+-+-+-+-+