+-+-+-+-+
|p      |
+ +-+ + +
| |   | |
+ + +-+-+
| |     |
+ +-+-+ +
|     |g|
+-+-+-+-+