+--+--+--+--+--+--+--+--+--+
|p       |                 |
+--+--+  +  +--+--+--+  +--+
|     |        |     |     |
+  +  +--+--+--+  +  +--+  +
|  |  |           |  |     |
+  +  +  +--+--+--+  +  +  +
|  |  |           |     |  |
+  +  +  +--+--+  +--+--+  +
|  |  |        |  |        |
+  +  +--+--+  +  +--+--+  +
|  |     |  |  |        |  |
+  +--+  +  +  +--+--+  +--+
|  |  |  |  |  |     |     |
+  +  +  +  +  +  +--+--+  +
|  |     |        |     |  |
+--+  +--+--+--+--+  +  +  +
|                    |    g|
+--+--+--+--+--+--+--+--+--+