+--+--+--+--+--+--+
|p                |
+  +--+  +--+--+--+
|     |     |     |
+--+--+--+  +  +  +
|        |     |  |
+  +--+  +--+  +  +
|     |     |  |  |
+--+  +--+  +--+  +
|     |  |     |  |
+  +--+  +--+--+  +
|                g|
+--+--+--+--+--+--+